....................................................................................................................................................................................................................................
....................................................................................................................................................................................................................................
....................................................................................................................................................................................................................................
....................................................................................................................................................................................................................................
....................................................................................................................................................................................................................................
....................................................................................................................................................................................................................................
....................................................................................................................................................................................................................................
....................................................................................................................................................................................................................................
....................................................................................................................................................................................................................................
....................................................................................................................................................................................................................................
....................................................................................................................................................................................................................................
....................................................................................................................................................................................................................................
....................................................................................................................................................................................................................................
....................................................................................................................................................................................................................................
....................................................................................................................................................................................................................................
....................................................................................................................................................................................................................................
.....................................................................................................................................E...................E.E........................................GG..............................
................................................................................................................................G...G...................GGG.....................................................GGG.................
..............................................................................................................E..........GGG.....................GGG................................................................................
........................................................................................................GGG.GGG.....................................................................................................................
............................................................................G..................................................................................................................G....................................
..P.........G.G..............................................E.............GG...GG...........G...................................G..........G.......................G..........G.....G.......GGG............G.....E.................
...........GG.GG...GE........G..G.......E..............G..................GGG...GGG....E..E.GGG...............E...E...E....E.....G..........GG.....................GG.....E.E..GG...GGG.....GGGG..........GGG...GGG.....E.........F.
GGGGGGGGGGGGGGGGGGGGGGGGGGGGGGGGGGGGGGGGGGGGGGGGGGGGGGGGGGGGGGGGGGGGGGGGGGGGGGGGGGGGGGGGGGGGGGGGGGGGGGGGGGGGGGGGGGGGGGGGGGGGGGGGGGGGGGGGGGGGGGGGGGGGGGGGGGGGGGGGGGGGGGGGGGGGGGGGGGGGGGGGGGGGGGGGGGGGGGGGGGGGGGGGGGGGGGGGGGGGGGGGGGGG